
F  164,169,20
C  153,40,223
EA textures/eatexture.xpm
WE textures/wetexture.xpm
SO textures/nsotexture.xpm  

NO textures/notexture.xpm

   
If strlen(curr_row) > strlen(row_on_top) && current col > strlen(row_on_top), current character should be '1'

111111111111111111111
    1001  1001 111 1001
   101   10011 101 11101
111111111111111111111

