
F  164,169,20
C  153,40,223
EA textures/eatexture.xpm
WE textures/wetexture.xpm
SO textures/nsotexture.xpm  

NO textures/notexture.xpm

1111111111111111111111111111111
1W00000000000000000000000000111
1000000000000000000000000000110
1000000000000000000000000000011
1111111111111111111111111111111