NO textures/simonkraft/wet_sponge.xpm
SO textures/simonkraft/wet_sponge.xpm
F 1,0,0   
WE textures/simonkraft/wet_sponge.xpm


C 153,204,255

EA textures/simonkraft/wet_sponge.xpm

111111111111111111111
1E0000000000000000001
100000000000000001111
111111111111111111111