NO textures/simonkraft/wet_sponge.xpm
SO textures/simonkraft/wet_sponge.xpm
WE textures/simonkraft/wet_sponge.xpm

F 1,0,0   

C 153,204,255

EA textures/simonkraft/wet_sponge.xpm

111111111111111111111
1E0000000000000000001
10000000000000000111
111111111111111111111