WE textures/wolfenstein/blue_stone.xpm 
NO textures/wolfenstein/grey_stone.xpm
EA textures/wolfenstein/mossy.xpm
SO textures/wolfenstein/red_brick.xpm

F 69,222,199
C 235,198,52

111111111111111111111111
100000000000000000000001
100000000000000000000001
100000000N00000000000001
100000000000000000000001
100000000000000000000001
100000000000000000000001
111111111111111111111111