NO textures/dyawli/uk.xpm
SO textures/dyawli/uk.xpm
WE textures/dyawli/uk.xpm
EA textures/dyawli/uk.xpm

F 1,0,0   

C 153,204,255


111111111111111111111
1E0000000000000000001
100000000001000000001
100000000000000000001
100000000000000000001
111111111111111111111